##########
#   #.   #
# # #.## #
# #  .#  #
# ### # ##
#   # ** #
### ###  #
#  ...#  #
# ###   ##
##########
