##########
#    #   #
# ##*# # #
#  #  *# #
## ### # #
#.   #   #
#.## ### #
#. #     #
# # ### ##
##########
