##########
#   .   D#
#*## ##  #
#**#..#  #
## ## ## #
#   .. # #
# #### # #
#    #   #
# ##   # #
##########
