##### ####
#   . D D#
#*## ##  #
#**#..#  #
## ##D## #
    .. #  
# #### # #
#    #   #
# ##   # #
##### ####
