##########
#        #
# ## ##  #
#  #  #  #
## ## ## #
#      # #
# #### # #
#    #   #
# ##   # #
##########
