##########
#   #    #
# # # ## #
# #   #  #
# ### # ##
#   #    #
### ###  #
#     #  #
# ###   ##
##########
