##########
#   #.   #
# # #.## #
# #  .#  #
# ### # ##
#   #    #
### ###  #
#  ...#  #
# ###   ##
##########
