##########
#    #   #
# ## # # #
#  #   # #
## ### # #
#.   #   #
#.## ### #
#. #     #
# # ### ##
##########
