##########
#    #   #
# ## # # #
#  #   # #
## ### # #
#    #   #
# ## ### #
#  #     #
# # ### ##
##########
