##########
#   .    #
# ## ##  #
#  #..#  #
## ## ## #
#   .. # #
# #### # #
#    #   #
# ##   # #
##########
